###############
#00000#0#0#000#
#0###0#####0###
#00004#0000003#
#####0#0#0#0###
#0#0#02000#000#
###############