#################################
#.#...........#.....#.....#.#...#
#.#.#########.#.#.###.###.#.#.#.#
#.#.......#...#.#.....#...#.#.#.#
#.###.#####.###.#######.#.#.###.#
#.....#.....#...#.....#.#.#...#.#
#.#####.#.###.###.###.#.#####.#.#
#.#.#...#.#...#...#...#.....#.#.#
#.#.#.#####.###.###.#######.#.#.#
#...#.#.....#.#.#.#...#...#...#.#
###.#.#.#####.#.#.###.#.#.#####.#
#...#...#...#.......#...#.......#
#.#######.###.#############.#.#.#
#.#.............#.....#...#.#.#.#
#.###############.###.#.#.###.#.#
#.................#.....#.....#.#
#################################