1111111
1000001
1110101
1410101
1011101
1302001
1111111