#######
#00000#
#0###0#
#4#0#0#
###0#0#
#30200#
#######